XXXXXXXXXXXXXXXXXXXXXXXXXXXXXXXXXXXXXXXXXXXXXXXXXXXXXXXXXXXXX
X                   X   X               X         X   X     X
XXXXXXX XXXXXXXXXXX X X X X XXXXXXXXXXX X XXXXXXX X XXX X XXX
X       X   X     X X X X X X         X X X       X     X   X
X XXX XXXXX X XXX X X X X X XXXXXXX X X X XXXXX XXXXXXXXXXX X
X X   X   X     X     X X X       X X     X   X     X       X
X XXX X X XXXXXXXXXXXXXXX XXXXXXX XXXXXXXXX X XXXXX X XXXXX X
X   X X X       X     X   X     X       X   X   X X X X   X X
X X X X XXXXXXX X XXX X XXX XXX XXXXXXX X XXXXX X X X X X X X
X X X X       X   X   X X     X   X   X   X   X X     X X X X
X X XXXXX XXXXXXXXX X X XXXXXXX X XXX XXXXX X X XXXXXXX XXX X
X X       X         X X         X X   X     X   X     X   X X
X XXXXXXXXX XXXXXXXXX XXXXXXXXXXX X X X XXXXXXXXX XXX XXX X X
X X       X X     X   X       X X   X X X       X X X   X   X
X X X XXXXX XXX X X XXX XXX X X XXXXX X X XXXXX X X XXX XXX X
X X X X   X   X X   X   X   X X   X X X   X X   X X   X   X X
X X XXX X X X XXX XXX XXX XXX X X X X XXXXX X XXX X XXXXX X X
X   X   X X X   X   X   X   X   X X X X     X   X X   X   X X
X XXX XXX X XXX XXXXXXX XXX XXXXX X X X X XXXXX X XXX X XXXXX
X X   X   X X   X     X X X     X   X X X     X X     X     X
X X XXX XXX X X X XXX X X XXXXX XXXXX XXX XXX X X XXXXXXX X X
X X   X   X X X X   X   X   X X     X   X X   X   X     X X X
X XXX XXX XXX X XXX XXXXX X X XXXXX XXX XXX X XXXXX XXX XXX X
X   X X X     X   X   X   X   X   X         X   X   X X   X X
XXX X X XXXXXXXXX XXX XXX X XXX X XXXXX XXXXXXXXX XXX XXX X X
X   X X           X X     X X   X X   X X       X X   X   X X
X XXX XXXXX XXXXXXX XXX XXXXX XXX X X XXX XXXXX X X XXX XXX X
X   X     X   X       X X     X X X X X       X     X   X   X
XXX XXXXX XXX XXXXX X X X XXXXX X X X X XXXXX XXXXXXX XXXXX X
P   X     X X       X X X X     X   X X X   X X X     X     X
X XXX XXXXX XXXXX XXXXX X XXX X XXXXX X X X XXX X XXXXX XXX X
X   X X   X       X     X   X X X   X   X X X   X X     X   K
XXX X X X X XXXXXXX XXXXXXX X X X X XXXXX X X XXX X XXXXX XXX
X   X   X X X   X   X     X X X X X   X   X   X   X   X X X X
X XXXXXXX X X X X XXX XXX X X X XXX X X XXXXXXX XXXXX X X X X
X X       X   X X X     X X   X X   X X         X   X X   X X
XXX XXXXXXXXXXX X XXX X XXXXXXX X XXX XXXXXXXXXXX X X X XXX X
X   X     X     X   X X       X X X X X   X       X   X   X X
X XXX XXX X XXXXXXX XXXXX XXX X X X X X X X X XXXXXXXXXXX X X
X X   X   X   X   X     X X X X X X X   X X X X     X       X
X X XXX XXXXX X X XXXXX X X X X X X XXXXX X X XXXXX X XXXXXXX
X X   X X     X X     X X X   X   X     X X X     X   X     X
X XXX X XXXXX XXXXXXX X X XXXXXXXXX XXX X X XXXXX XXXXX XXX X
X     X     X         X X   X       X X X X X   X       X X X
X XXXXXXXXX XXXXXXX XXX X X X XXX XXX X X X XXX XXXXXXXXX X X
X   X     X X     X X   X X     X X     X X   X           X X
XXX X XXX X X XXX XXX XXXXXXXXX X XXXXX X XXX XXX XXX XXXXX X
X X X X X X   X X     X       X X X   X X X   X   X   X     X
X X X X X XXXXX XXXXXXX XXXXX X X X X XXX X XXX X XXXXX XXXXX
X X   X   X     X   X   X   X X X   X X   X     X X   X     X
X XXXXX XXX X X X X X XXXXX X XXXXX X X XXXXXXXXXXX X XXX X X
X     X X X X X   X   X     X     X X X X         X X   X X X
X XXX X X X X XXXXXXXXX X XXXXXXX X X X X XXXXXXX X XXX XXX X
X   X X X   X X         X X     X X X X X     X X   X X X   X
XXX XXX X XXX X XXXXXXX XXX XXX X XXX X XXXXX X XXXXX X X X X
X   X   X   X X X     X X   X X X     X     X X       X X X X
X XXX XXX XXX X X XXXXX X XXX X XXXXX XXXXX X X XXXXXXX X X X
X   X X   X   X   X     X X   X     X X   X   X         X X X
X X X XXXXX XXXXX X XXXXX XXX X XXXXX X X XXXXX XXXXXXXXX X X
X X         X     X           X         X     X           X X
XXXXXXXXXXXXXXXXXXXXXXXXXXXXXXXXXXXXXXXXXXXXXXXXXXXXXXXXXXXXX
