XXXXXXXXXXXXXXXXXXXXXXXXXXXXXXXXXXXXXXXXXXXXXXXXXXXXXXXXXXXXXXXXXXXXXXXXXXXXXXXXXXXXXXXXXXXXXXXXXXXXX
P   X   X   X                 X         X         X                   X   X               X   X     X
XXX X X X X X XXXXX XXXXXXXXX X X X XXXXX XXX XXX X XXXXX XXX XXXXXXX X X X XXXXXXXXXXXXXXX X X XXX X
X X   X   X X X   X         X X X X X     X   X   X X   X X   X   X X   X   X     X   X   X X   X X X
X XXXXXXXXX X X X XXXXXXXXX X XXX XXX XXXXX XXX XXX XXX X XXXXX X X XXXXXXX X XXX X X X X X XXXXX X X
X X       X X   X       X   X X   X   X   X X     X   X X       X X   X   X X   X X X   X X   X   X X
X X X XXX X XXXXXXXXXXXXX XXX X XXX XXX X X X XXXXXXX X XXXXXXXXX X X X X X X XXX X XXXXX XXX X X X X
X   X   X X               X X X   X X   X X X X     X   X         X X X X   X X   X     X     X X X X
X XXXXX X XXXXXXXXXXXXXXXXX X XXX X X XXX X XXX X XXXXX X XXXXXXXXX X X XXXXX X X XXXXX XXXXXXXXX X X
X     X X         X     X     X   X X X   X     X       X       X   X     X   X X X     X         X X
XXX XXX XXXXXXXXX XXXXX X XXXXX X X XXX XXXXXXXXXXXXXXXXXXXXXXX X XXXXXXX X XXX XXX XXXXX X XXXXXXX X
X   X   X             X X   X   X X   X         X         X   X X   X   X X   X   X       X X       X
X XXX XXXXXXXXXXXXXXX X XXX X XXXXXXX X XXX XXX X XXXXXXX XXX X XXXXX X XXXXX XXX XXXXXXXXX X XXXXXXX
X   X       X     X     X   X       X X   X X X   X     X X   X X   X X     X X X         X X   X   X
X XXXXXXXXX X XXX XXXXXXX XXXXXXX X X XXXXX X XXXXX X XXX X X X X X X XXXXX X X XXXXXXX XXX XXX X X X
X X         X   X X       X       X X X     X       X X   X X X   X   X   X   X       X X     X   X X
XXX XXXXXXX XXX X X XXXXXXX XXXXXXX X X XXXXX XXXXX X X XXX XXXXXXXXXXX X XXXXXXX XXX X X XXXXXXXXX X
X   X       X   X   X   X     X     X X X   X     X X X X               X X       X X X   X         X
X XXXXXXXXX X XXXXXXX X X XXX XXXXXXX X X XXXXXXX X XXX XXXXXXXXX X XXXXX XXX XXXXX X XXXXX X XXXXX X
X         X X X       X X X X X   X   X X     X   X   X X   X   X X X   X     X   X   X   X X X   X X
X XXXXXXX XXX XXXXX X XXX X X X X X XXX X X XXX XXXXX X X X X X X XXX X XXXXXXX XXX XXXXX X XXX X XXX
X X     X   X     X X   X X X X X X X   X X X       X X X X   X X X   X X     X   X X     X     X   X
X X XXX XXX XXXXX XXXXX X X X X X X XXX XXX X XXXXXXX X X XXXXX X X XXX X XXX X X X X X X XXXXXXXXX X
X X X X       X   X     X X X   X   X   X   X   X     X X   X X X X   X   X   X X   X X X     X     X
X X X XXXXXXX X XXX XXXXX X XXXXXXXXX XXX XXXXX X XXXXX XXX X X X XXX XXXXX XXX XXXXXXX XXXXX X XXX X
X X X   X     X X         X   X       X   X   X X           X X X X   X   X X   X       X   X X X X X
X X XXX X XXXXX XXXXXXX XXX X X X XXXXX X X X X XXXXXXXXXXXXX X X X XXX XXX X XXXXX XXXXX X XXX X X X
X X X   X   X X   X   X     X X X     X X   X X X     X     X     X   X X   X       X     X     X   X
XXX X XXXXX X XXX X X XXXXXXX XXXXX X X XXXXX X X XXX X XXX XXXXXXX X X X XXX XXXXX X XXXXXXXXXXX XXX
X   X X   X X   X   X X     X     X X X   X X X   X   X X   X     X X X X   X X   X X X     X   X X X
X XXX X X X X X XXXXX X XXX XXXXX XXX XXX X X X XXXXXXX X XXX XXX XXX X XXX XXX X XXX X XXX X X X X X
X X   X X   X X     X X   X   X       X     X X X       X X   X X     X   X     X   X   X X X X X X X
X X X X XXXXX XXXXX X X X XXX X XXXXXXXXXXXXX X X XXXXXXX XXX X XXXXXXX X XXXXXXXXX X XXX X X XXX X X
X X X   X     X   X X X X X   X X X     X   X   X X X   X X   X       X X         X X   X X X   X X X
X XXXXX XXXXX XXX X X XXX X XXX X X XXX X X XXXXX X X X X X XXX XXXXX XXXXXXXXXXX X XXX X X X X X X X
X X   X X   X X   X X     X   X X X   X   X   X   X   X X   X       X X       X   X X X X X X X     X
X X X X X X X X XXX XXXXXXXXX X X XXX XXXXXXX X XXX XXX XXXXXXXXXXX X X XXXXX X X X X X X X XXXXXXX X
X X X X   X   X             X X   X   X   X   X X   X X             X   X   X X X X X X   X     X   X
X X X XXXXXXXXX XXXXXXXXXXX X XXXXX XXXXX X XXX X XXX XXXXX XXXXXXXXXXXXX X X X XXX X XXX XXXXX X XXX
X   X   X     X X         X X     X X     X     X   X     X X   X   X     X     X   X     X   X X X X
XXXXXXX X X XXX X XXXXXXX XXXXXXX X X XXX XXXXXXXXX XXXXX X X X X XXX XXXXXXXXXXX XXXXX XXX X X X X X
X     X X X     X X   X   X     X   X X X   X     X       X   X X   X X       X   X   X X   X X X   X
X XXX X XXX XXXXX X XXX X X XXX XXXXX X XXX X XXX XXX XXXXXXXXX X X X X XXXXX X XXX X XXX XXX X XXX X
X X   X   X X     X   X X X X     X   X     X   X   X X       X X X X X X     X X   X     X   X X X X
X XXX XXX X X XXXXXXX X XXX X XXX X XXX XXXXXXX XXX X X XXXXX X X X X X X XXXXX X XXXXXXXXX XXX X X X
X   X X   X X     X   X     X X   X X X   X   X X X X X   X X   X X   X X     X   X       X     X X X
X X X X XXX XXXXX X XXXXXXXXX X XXX X XXX X X X X X X XXX X XXXXX XXXXX XXXXX XXXXX XXXXX XXXXXXX X X
X X X   X     X X X       X   X     X   X   X   X X X   X X   X   X   X X         X X     X   X     X
XXX XXXXXXXXX X X XXX XXX X XXX XXXXX X XXXXXXXXX X X XXX X XXX XXX X XXX XXXXXXX X X XXX XXX X XXXXX
X   X       X   X     X X X X   X   X X   X   X     X X   X         X   X X   X   X X X X X   X X   X
X XXX XXXXX X XXXXXXXXX X X XXXXX X XXX XXX X X XXXXXXX XXX XXXXXXXXXXX X X X XXX XXX X X X X X XXX X
X     X     X X   X   X   X       X X   X   X X       X X     X   X X   X   X   X     X X   X X   X X
XXXXXXX XXXXXXX X X X X XXXXXXXXXXX X XXX XXX XXXXXXX X XXXXXXX X X X XXXXX XXX XXXXXXX X XXXXXXX X X
X       X       X   X X X X   X   X X X   X X X     X   X       X X       X   X     X   X X       X X
X XXXXX X XXXXXXXXXXX X X X X X X X X X XXX X X XXX XXX X XXXXXXX XXXXXXX XXX XXXXX X X X X XXXXXXX X
X   X   X   X       X   X   X   X X X       X     X X   X X     X     X   X   X   X X X   X     X   X
XXX X XXXXX X XXXXX XXXXX XXXXXXX X XXXXXXX XXXXXXX X XXX X X XXXXXXX XXX XXX X XXX XXXXX XXXXX X X X
X   X     X X   X     X   X   X   X       X X   X   X X X X X     X X   X   X   X   X   X X   X   X X
X XXX XXXXX XXX X XXX X XXX X X XXXXXXXXX X XXX X XXX X X X XXX X X XXX XXX XXX X XXX X X X XXXXXXX X
X X   X     X   X X X X   X X X         X X   X X       X X X   X   X   X   X   X X   X X X X     X X
X X XXX XXXXXXXXX X X XXXXX X XXX X XXX X XXX X XXXXXXXXX XXX XXXXXXX XXX XXX XXX X XXX X X X XXX X X
X X   X         X X X X     X   X X   X X   X X X         X   X     X   X   X X   X X X X   X   X X X
X XXXXXXXXXXXXX X X X X XXXXXXX X XXX XXXXX X X X XXXXXXXXX XXX XXX XXX XXX XXX XXX X X XXXXXXX X X X
X X   X       X   X X X     X X X X   X     X   X       X       X X   X   X   X   X   X         X X X
X X X X XXXXX XXXXX X XXXXX X X X X XXX XXXXXXX XXXXXXX X XXXXXXX XXX XXX XXX X X XXX XXXXXXXXXXX X X
X X X   X   X       X       X X X X   X   X     X     X X X     X   X   X   X X X       X   X   X X X
X X XXXXXXX X XXXXXXXXXXXXXXX X X XXX XXX XXXXXXX X XXX X X XXX X X XXX XXX X XXXXXXXXX X X X X X X X
X X         X X     X       X   X X     X     X   X X   X X X   X X   X   X X       X   X X   X   X X
X XXXXXXXXX X X XXX X X XXX X XXXXX XXX XXXXX X XXX X XXX X X XXX X X XXX X XXXXXXX XXXXX XXXXXXXXX X
X X   X   X X     X X X X X X       X   X X   X X X X X   X X     X X X   X     X         X       X X
X X X X X X XXXXXXX X X X X XXXXXXXXX XXX X XXX X X X X XXX XXXXXXX XXX X XXXXX XXXXXXXXXXX XXXXX X X
X   X   X     X     X X X X X   X     X   X X   X X X X X X X     X X   X     X       X     X   X   X
X XXXXXXXXXXXXX XXX X X X X X X X XXXXX XXX X XXX X X X X X X XXX X X XXXXXXX XXXXXXX X XXXXX X XXXXX
X     X     X   X   X X X     X X X     X   X   X X   X X   X   X   X X X   X   X   X X X X   X X   X
XXXXX X XXX X XXXXXXX X X XXXXX X XXX X X XXXXX X XXXXX XXXXXXX XXX X X X X XXX X X X X X X X X X X X
X   X X X   X   X   X X X X   X X X   X X       X     X   X     X   X X   X   X   X X X X X X X   X X
X XXX XXX XXXXX X X X X XXX X XXX X XXXXXXXXXXXXX XXX XXX X XXXXX XXX XXXXXXX XXXXX X X X X X XXXXX X
X   X   X     X   X   X X   X     X       X   X     X X   X X X   X X       X   X   X X X   X X   X X
X X XXX XXXXX XXXXXXXXX X XXXXXXXXX XXX X XXX X XXXXX X XXX X X XXX XXXXXXX X X X XXX X X XXX X X X X
X X   X       X       X X X       X   X X     X X X   X   X X     X     X   X X X X X X X   X X X   X
X XXX XXXXXXX XXX XXX X X X XXXXX XXXXX XXXXXXX X X X XXX X XXXXX X XXX X XXXXX X X X X XXX X X XXXXX
X   X       X     X X X X   X     X   X X     X X X X   X X     X   X   X X     X X X X   X X X   X X
XXXXX XXXXXXXXXXXXX X X XXXXX XXXXX X X X XXX X X X XXXXX XXXXX XXXXX XXX X X XXX X X XXX XXX XXX X X
X     X           X   X       X     X   X X X   X X X     X     X   X X   X X     X X   X     X X   X
X XXXXX XXXXXXX XXX XXXXXXXXXXX X XXXXXXX X XXXXX X X XXXXX X XXX X XXX XXX XXXXXXX X XXXXXXXXX XXX X
X X   X     X X     X   X   X   X   X   X X       X X X     X X   X     X X       X X         X     X
X X X XXXXX X XXXXXXXXX X X X XXXXX X X X X XXXXXXX X X XXXXXXX XXXXXXXXX XXXXXXX X XXXXXXXXX X XXXXX
X   X       X   X       X X   X   X   X     X   X   X X X       X     X           X X         X   X X
X XXXXXXXXXXX X X X X XXX XXXXXXX XXXXXXXXXXX X X XXX X X XXXXXXX X X X XXXXXXXXXXX X X XXXXX XXX X X
X   X         X   X X X   X     X         X   X X X   X X X       X X X X X         X X X   X X   X X
XXX X XXXXXXXXXXXXX X X XXX XXX XXX XXXXX X XXX X X XXX X X XXXXX X X X X X X XXXXX X XXX X XXX XXX X
X   X         X     X X X   X X   X X   X X X     X     X X X   X X X X X   X   X   X   X X X   X   X
X XXX XXXXXXX X XXXXXXX XXX X XXX X X XXX X XXXXXXXXXXX X X X X XXX XXX XXXXXXX X XXXXX X X X XXXXX X
X X   X   X X X             X       X     X           X X X X X     X   X     X X     X   X X X     X
X X XXX X X X XXXXXXXXXXXXXXXXXXXXXXX XXXXXXXXXXX X XXX X X X XXXXXXX XXX XXX X X XXXXXXXXX X X XXX X
X X X   X X       X             X   X   X       X X     X X X       X   X X X X X X         X   X X X
X XXX XXX XXXXXXXXX XXXXXXXXXXX X X X XXX XXXXX X XXXXX X X XXXXXXX XXX X X X X XXX XXXXXXXXXXXXX X X
X     X X X         X   X     X X X   X   X   X X X   X X X   X   X     X X   X   X     X         X X
XXXXXXX X X XXXXXXXXX XXX X XXX XXXXXXX XXX X X XXX X XXX XXX XXX XXXXXXX X XXXXX XXXXX X X XXXXXXX X
X           X             X             X   X       X     X               X           X   X         K
XXXXXXXXXXXXXXXXXXXXXXXXXXXXXXXXXXXXXXXXXXXXXXXXXXXXXXXXXXXXXXXXXXXXXXXXXXXXXXXXXXXXXXXXXXXXXXXXXXXXX
