XXXXXXXXXXXXXXXXXXXXXXXXXXXXXXXXXXXXXXXXXXXXXXXXX
P       X         X     X   X   X         X     X
XXX XXX X XXX X XXX X X X X X X X X XXXXX X XXX X
X   X X X X X X X   X X   X X X X X X   X X   X X
X XXX X X X X XXX XXX XXXXX X XXX X XXX X XXX X X
X X   X X   X     X X   X X X   X X   X X X   X X
X XXX X XXX XXXXXXX XXX X X X X X XXX X X XXXXX X
X   X   X   X         X X   X X     X X     X   X
X X XXXXX XXXXXXXXXXX X XXX XXXXXXX X XXXXX X XXX
X X     X   X         X   X   X   X X     X X   X
X XXXXX XXX X XXXXXXX XXX XXX X X XXXXXXX X X X X
X X   X X   X   X   X X X X   X X         X X X X
X X X X X XXX X XXX X X X XXX X XXXXXXXXXXX XXX X
X X X   X   X X   X X X X   X X     X     X   X X
XXX XXX XXX XXXXX X X X XXX X XXXXX X XXX XXX X X
X   X     X     X X     X   X     X X   X   X   X
X XXX XXXXXXXXX X XXXXXXX XXXXXXX X XXX XXX XXX X
X   X X       X X X   X   X     X X   X X X   X X
X X XXX X XXXXX X X X X XXX XXX X XXX X X XXX X X
X X     X X     X X X   X   X X X X   X X   X   X
X XXXXXXX X XXXXX X XXXXX XXX X X X XXX X X XXXXX
X X     X X   X   X X       X   X   X X   X X   X
X XXXXX X XXX X X X XXXXXXX XXXXXXXXX XXXXX X X X
X       X   X X X X       X         X     X X X X
XXXXXXX X X X XXX XXXXXXX XXXXX XXX X XXX X X XXX
X   X   X X X X         X X   X   X   X   X X   X
X XXX XXX XXX X XXXXXXX X X X XXXXXXXXX XXX XXX X
X   X X X   X   X X     X X X   X     X         X
X X X X XXX XXXXX X XXXXX X XXX X XXX XXXXXXXXX X
X X       X         X   X   X   X X X X       X X
X XXXXXXX XXXXXXXXXXX X XXX X XXX X X X XXXXX XXX
X X   X X X X   X     X   X X X     X X X   X   X
XXX X X X X X X X XXXXXXX XXX X XXXXX X X X XXX X
X   X X     X X X X     X   X X   X   X   X X   X
X XXX XXXXXXX X X X XXX XXX X X XXX XXXXXXX X X X
X X   X     X X X   X   X X X   X   X     X X X X
X X XXX XXX X X X XXX XXX X XXXXX XXX X XXX X X X
X X X   X   X X X   X X         X     X     X X X
X X X XXX XXX X XXXXX X XXXXXXX X XXXXXXX XXX X X
X X   X       X   X   X X     X X X     X   X X X
X XXXXXXXXXXXXXXX X X XXX XXX X XXX XXX XXXXX X X
X X     X   X   X   X X     X X     X X   X   X X
X X XXX X X X XXX XXXXX XXXXX XXXXXXX XXX X XXX X
X X   X X X X     X       X   X         X   X X X
X XXX X X X XXXXX X XXXXXXX XXXXX XXXXXXXXXXX X X
X   X X   X     X X X X   X X     X           X X
X XXX XXXXXXXXX XXX X XXX X X X XXX XXXXXXX XXX X
X             X         X   X X           X     K
XXXXXXXXXXXXXXXXXXXXXXXXXXXXXXXXXXXXXXXXXXXXXXXXX